XXXXXXXXXXXXXXXXXXXX
XXXXSXXXXXXXXXXXXXFX
FXXXXXXXXXXXXXXSXXLX
XXXXXXXXXXXXPPPPPPPP
XXXXXXXXLXXXXXXXXXXX
XXXXXXXPPPXXXXXXXXXX
XXXXXXXXXXXXXXXXXXXX
MXXXXXXXXXXXXXXXXXXX
XXPPPPXXXXXXXXXXXXXX
XXXXXXXXXXXXXXXXXXXX
XXXXXXXXLXXXXXXXXXXX
XXXXXXXPPPXXXXXXXXXX
XXXXXXXXXXXXXXXXXXLX
XXXXXXXXXXXXPPPPPPPP
XXXXXXXXXXXXXXXXXSXX
XXXXXXXXXXXXXXXXXXXX
XXXXXXXXXXXXXXXXXXXX
XXAXXXXXIXXXXXXXXXXX
PPPPPPPPPPPPPPPPPPPP