XXXXXXXXXXXXXXXXXXXX
MXXXXXXXXXXXXXXXXXXM
XLXSXXXXXXXXXXXSXXLX
PPPPXXXXXXXXXXXPPPPP
XXXXXXXXLXXXXXXXXXXX
XXXXXXXXPPPXXXXXXXXX
XXXXXXXXXXXXXXXXXXXX
MXXXXXXXXXXXXXXXXXXM
XXXXXXXXXXXXXXXXXXXX
XXXXXXXXXXXXXXXXXXXX
XXXXXXXXLXXXXXXXXXXX
XXXXXXXXPPPXXXXXXXXX
XXXXXXXXXXXXXXXXXXXX
XXXXXXXXXXXXXXXXXXXX
XXXXXXXXXXXXXXXXXSXX
XXXXXXXXXXXXXXXXXXXX
XXXXXXXXXXXXXXXXXXXX
XXAXXXXXIXXXXXXXXXXX
PPPPPPPPPPPPPPPPPPPP