XXXXSXXXXXXXXXXXXXXX
PPPPPPPPPPXXXXXXXXSX
SXXXXXXXXXXXXXXSXXLX
XXXXXXXXXXPPPPPPPPPP
XXXXXXXXLXXXXXXXXXXX
PPPPPPPPPPXXXXXXXXXX
XXXXLXXXXXXXXXXXXXXX
MXXXXXXXXXXXLLLLLXXX
XXPPPPXXXXXXXXXXXXXX
XXXXXXXXXPPPPPPPPPPP
XXXXXXXXLXXXXXXXXXXX
XXXXXXXPPPXXXXXXXXXX
XXXXXXXXXXXXXXXXXXLX
XXXXXXXXXXXXPPPPPPPP
LLLLLXXXXXXXXXXXXSXX
PPPPPPPPPPPPPXXXXXXX
XXXXXXXXXXXXXXXXXXXX
XXAXXXXXIXXXXXXXXXXX
PPPPPPPPPPPPPPPPPPPP