XXXXXXXXXXXXXXXXXXXX
XXXXXXXXXXXXXXXXXXXX
FXXXXXXXXXXXXXXSXXXX
XXXXXXXXXXXXPPPPPPPP
XXXXXXXXXXXXXXXXXXXX
XXXXXXXPPPXXXXXXXXXX
XXXXXXXXXXXXXXXXXXXS
MXXXXXXXXXXXXXXXXXXP
XXPPPPXXXXXXXXXXXXXX
XXXXXXXXXXXXXXXXXXXX
XXMMMMMMMXXXXXXXXXXX
XXFFFFFFFXXXXXXXXXXS
XXXXXXXXXXXXXXXXXXLP
XXXXXXXXXXXXXXXXXXXX
SXXXXXXXXXXXXXXXXSXX
PXXXXXXXXXXXXXXXXXXX
XXXXXXXXXXXXXXXXXXXX
XXAXXXXXIXXXXLLLLXXX
PPPPPPPPPPPPPPPPPPPP