XXXXXXXXXXXXXXXXXXXX
XXXXSXXXXXXXXXXXXXFX
FXXXXXXLXXXLXXXSXXLX
PPPPPPPPPPPPPPXXPPPP
PPPXXPPPPPPPPPPPPPPP
XXXXXXXPPPXXXXXXXXXX
XXXXXXXXXXXXXXXXXXXX
MXXXXXXXXXXXXXXXXXXX
XXPPPPXXXXXXXXXXXXXX
XXXXXXXXXXXXXXXXXXXX
XXXXXXXXLXXXXXXXXXXX
SSSXXXXPPPXXXXXXXXXX
PPPPPPPPPPPPPPPPPPXS
XXXXXXXXXXXXPPPPPPXX
XXXXXXXXXXXXXXXXXSXX
XXXXXXXXXXXXXXXXXXXX
XXXXXXXXXXXXXXXXXXXX
XXAXXXXXIXXXXXXXXXXX
PPPPPPPPPPPPPPPPPPPP