MXXXXXXXXXXXXXXXXXXM
XXXXXXXXXXXXXXXXXXXL
XXXXXXXXXXXXXXXXPPPP
XXXXXXXXXXXXXXXXXXXX
MXXXXXXXXXXXXXXXXXXM
XXXXXXXXXXXXXXXXSXXL
XXXXXXXXXXXXPPPPPPPP
XXXXXXXXXXXXXXXXXXXX
MXXXXXXXXXXXXXXXXXXM
XXXXXXXXXXXXXXXXXXXL
XXXXXXXXXXXXXXXXPPPP
XXXXXXXXXXXXXXXXXXXX
MXXXXXXXXXXXXXXXXXXM
XXXXXXXXXXXXXXXXXXSX
XXXXXXXXXXXPPPPPPPPP
XXXXXXXXXXXXXXXXXXXX
XXXXXXXXXXXXXXXXXXXX
IXXXAXXXXXXXXXXXXXXS
PPPPPPPPPPPPPPPPPPPP