XXXXXXXXXXXXXXXXXXXX
XXXXXXXXXXXXXXXXXXXX
XXXXXXXXXXXXXXXXXXXX
XXXXSXXXXXXXSXXXXXXX
XXXXPXXXXXXXPXXXXXXX
XXXXXXXXSXXXXXXXXXXX
XXXXXXXXPXXXXXXXXXXX
XXXXXXXXXXXXXXXXXXXX
XXXXLXXXXXXXLXXXXXXX
XXXXPXLXLXLXPXXXXXXX
XXXXXXPXPXPXXXXXXXXX
XXXXXXXXXXXXXXXXXXXX
XXXXXXXXXXXXXXXXXXXX
XXXXXXXXXXXXXXXXXXXX
XXXXXXXXXXXXXXXXXXXX
XXXXXXXXXXXXXXXXXXXX
XXXXXXXXXXXXXXXXXXXX
XXIXXXXXXAXXXXXXXXXX
PPPPPPPPPPPPPPPPPPPP