FXXXXXXXLSLXXXXXXXXF
XXXXXXPPPPPPPXXXXXXX
XXXXXXXXXXXXXXXXXXXX
XXXXXXXXXXXXXXXXXXXX
LXXXXXXXXXXXXXXXXXXL
PPPXXXXXXXXXXXXXXPPP
XXXXXXXXXXXXXXXXXXXX
XXXXXXXXXXXXXXXXXXXX
XXXXXXXXXXXXXXXXXXXX
XXXXXXXXXXXXXXXXXXXX
XXXXXXXXXXXXXXXXXXXX
XXXXXXXXXXXXXXXXXXXX
SXXXXXXXXXXXXXXXXXXS
PPPXXXXXXXXXXXXXXPPP
XXXXXXXXXXXXXXXXXXXX
XXXXXXXXXXXXXXXXXXXX
XXXXXXXXXXXXXXXXXXXX
FXXXXXXXIXXXXXXXXAXF
PPPPPPPPPPPPPPPPPPPP